W W W W W W W W W W W W W W W W W W W W W W W W W W W W W W W W W W W W W W W W W W W W W W W W W W
W P G G G G G G G G D G G G G G G G G G G G G G G G G G G G G G G G G G G G G G G G G G G G G G G W
W G G G G G G R G G G G R D G G G G G G G R G G G G G G G G G G G G G R G G G G G G G G G G G G G W
W G G G G D G G G G G G G G G G G D G G G G G G D G G G G G G G G G G G G G G G G G G G G G G G G W
W G G R G G G D G G R G R G G G G G G G G G R G G G D G G R G G G G G G G G G D G G G G G G G G G W
W G G G G G G G G G G G G G G G G G G G G G G G G G G G G G G G G G G G G G G R G G G G G G G G G W
W W W W W W W W W W W W W W W W W W W W W W W W W W W W W W W W W W G G G G D G G G G G G G G G G W
W G G G G G G G G G G G G G G G G G G G G G G G G G G G G G G G G G G G G G G G G G G G G G G G G W
W G G G G G G G G G G G G G G G G G G G G G G G G G G G G G G G G G G G G G G G G G G G G G G G G W
W G G G G G G G G D G G G G G G G G G D G G R G G G G D G G G G G G G G G G G G G G G G G G G G G W
W G G G G G G G G G R G G G G G G G G G G G G G G G G G G G G G G G G G G G G G G G R G G G G G G W
W G G G G G G G G G G G G G G G G G G G G G G G G G G G D G G G G R G G G G G G G G G G G G G G G W
W G G G G G G G G G G G G G G G G G G G G G G G G G G G G G G G G G G G G G G G G G G G G G G G G W
W G G G G G G G R G G G G G G D G G G G G G D G G G G G G G G G G G G G G G G G G G G G G G G G G W
W G G G G G G G G G G G G G G G G G G G G G G G G G G G G G G G G G G G G G G G G G G G G G G G G W
W G G G G R G G G G G G G G G G G G G G G G G G G G G G G G G G G G G G G G G G G G G G G G G G G W
W G G G G G G G G G G G G G G G W W W W W W W W W W W W W W W W W W W W W W W W W W W W W W W W W W
W G G G G G G G G D G G G G G G G G G G G G G G G G G G G G G G G G G G G G G G G G G G G G G G G W
W G G G G G G G G G R G G G G G G G G G G G G G G G G G G R G G G G G G G G G G G G G G G G G G G W
W G G G G G G G G G G G G G G G G R G G G G G G G G G G G G G G G G G G G G G G G G G G G G G G G W
W G G G G G D G G G G G G G G G G G G G G G G G G G G G G G G G G G G G R G G G D G G G G G G G G W
W G G G G G G G G G G G G G G G G G G G G G G G G G G D G G G G G G G G G G G G R G G G G G G G G W
W G G G G G G G G G G G G G G G G G D R G G G G G G G G G G R G G G G G G D G G G G G G R G G G G W
W G G G G G G G G G G G G G G G G G G G G G G G G G G G D G G G G G G G G G G G G G G G G G G G G W
W G G G G G G G G G G G G G G G G G G G G G G G G G G G G G G G G G G G G G G G G D G G G D G G G W
W W W W W W W W W W W W W W W W W W W W W W W W W W W W W W W W W W G G G G G G G G G G G G G G G W
W G G G G G G G G G G G G G G G G G G G G G G G G G G G G G G G G G G G G R G G G G G G G G G G G W
W G G G G G G G G G G G G G G G G R G G G G R G G G G G G G G G G G G G G G G G G G G G R G G G G W
W G G G G G G G G G R G G G G G G G G G G G G G R G G G R G G D G G R G G G G G G D G G G G G G G W
W G G G G G G R G G G G G G G G G G G G G G G G G G D G G G G G G G G G G G G G G G G G G G G G G W
W G G G G G G G G G G G G G G G D G G G R G G G G R G G G G G G R G G G G G G G R G G G G G G G G W
W G G R G D G G G G G G G G R G G G G G G G G G G G G G G G G G G G G G G G G G G G G G G G G G G W
W G G G G G G G G G G D G G G G G G G G G G G G G G G G G G G G G G G G G G G G G G G G G G G G G W
W O O O O G G G G G G G G G G G G G G G G G G G G G G G G G G G G G G G G G G G G G G G G G G G G W
W W W W W W W W W W W W W W W W W W W W W W W W W W W W W W W W W W W W W W W W W W W W W W W W W W