W W W W W W W W W W W W W W W W W W W W W W W W W W W W W W W W W W W W W W W W W W W W W W W W W W 
W G G G G G G G G G G G G G G G G G G G G G G G G G G G G G G G G G G G G G G G G G G G G G G G P W 
W G G G G G G R G D G G R D G G G G G G G R G G G G G G D G G G G G G R G G G D G G G G G G G G G W
W G G G G G G G G G G G G G G G G G G G G G G G D G G G G G G G G G G G G G G G G G G G G G G G D W
W G G R G G G D G G R G R G G G G D G G G G R G G G D G G R G G G G G G G G G G G G G G G G G G G W
W G G G G G G G G G G G G G G G G G G G G G G G G G G G G G G G G G G G G G G R G G G G G G G G G W 
W W W W W W W W W W W W W W W W W W W W W W W W G G W W W W W W W W W W W W W W W W W W W W W W W W 
W G G G G G G G G G G G G G G G G G G G G G G W G G W G G G G G G G G G G G G G G G G G G G G G G W 
W G G G G G G G G G G G G G G G G G G D G G R G G G G D G G G G G G G G G G G G G G G G G G G G G W 
W G G G G G G G G G R G G G G G G G G G G G G G G D G G G G G G G G G G G G G G G G R G G G G G G W
W G G G G G G G G G G G G G G G G G G G G G G G G G G G D G G G G R G G G G G G G G G G G G G G G W  
W G G G G G G G G G G G G G G G G G G G R G G G G G G G G G G G G G G G G G G G G G G G G G G G G W 
W G G G G G G G R G G G G G G D G G G G G G G G G G G G G G G G G G G G G G G G G G G G G G G G G W  
W G G G G R G G G G G G G G G G G G G G G G G G G G G G G G G G G G G G G G G G G G G G G G G G G W 
W W W W W W W W W W W W W W W W W W W W W W W W W W W W W W W W W W W W W W W W W W W W W W W W G W  
W G G G G G G G G D G G G G G G G G G G G G G G G G G G G G G G G G G G G G G G G G G G G G G W G W 
W G G G G G G G G G R G G G G G G G G G G G G G G G G G G R G G G G G G G G G G G G G G G W W W G W 
W G G G G G G G G G G G G G G G G R G G G G G G G G G G G G G G G G G G G G G G G G G G G G G G G W 
W G G G G G D G G G G G G G G G G G G G G G G G G G G G G G G G G G G G R G G G D G G G G W W W W W 
W G G G G G D G G G G G G R G G G G G D G G G G G G G G G G G G G G G G G G G G G G G G G G G G G W
W G G G G G G G G G G G G G G G G G G G G G G G G G G G G G G G G G G G G G G G R G G G G G G G G W 
W G G G G G G G G G G G G G G G G G D R G G G G G G G G G G R G G G G G D G G G G G G G R G G G G W
W G G G G G G G G G G G G G G G G G G G G G G G G G G G D G G G G G G G G G G G G G G G G G G G G W 
W G G G G G G G G G G G G G G G G G G G G G G G G G G G G G G G G G G G G G G G G D G G G G G G G W 
W G W W W W W W W W W W W W W W W W W W W W W W W W W W W W W W W W W W W W W W W W W W W W W W W W
W G W G G G G G G G G G G G G G G G G G G G G G G G G G G G G G G G G G G R G G G G G G G G G G G W 
W G W W G G G G G G G G G G G G G R G G G G R G G G G G G G G G G G G G G G G G G G G G R G G G G W 
W G G G G G G G G G R G G G G G G G G G G G G G R G G G R G G D G G R G G G G G G D G G G G G G G W 
W W W W R G G G G G G G G G G G G G G G G G G G G G G G G G G G G G G G G G G G G G G G G G G G G W  
W G G G G G G R G G G G G G G G G G G G G G G G G G D G G G G G G G G G G G G G G G G G G G G G G W 
W G G G G G G G G G G G G G G G D G G G R G G G G R G G G G G G R G G G G G G G R G G G G G G G G W 
W G G R G D G G G G G G G G R G G G G G G G G G G G G G G G D G G G G G G G G G G G G G G G G G G W
W G G G G G G G G G G D G G G G G G G G G G G G G G G G G G G G G G G G G G G G G G G G G G G G G W 
W G G G G G G G G G G G G G G G G G G G G G G G G G G G G G G G G G G G G G G G G G G G G O O O O W 
W W W W W W W W W W W W W W W W W W W W W W W W W W W W W W W W W W W W W W W W W W W W W W W W W W