W W W W W W W W W W W W W W W W W W W W W W W W W W W W W W W W W W W W W W W W W W W W W W W W W W 
W G G G G G G G W G G G G G G G G G G G W G G G G G G P G G D G G G W G G G D G G G G G G G G G G W
W G G G G G G R W G G G R D G D G G G G W G R G G G G G G G G G G G W R G G G G G G G R G G R G G W
W G G G G G G G G G G G G G G G G G G G G G G G D G G G G G G G G G G G G G G G G G G G G G G G G W 
W G G R G D G D W G R G R G G G G G G G W G R G G G D G G R G G G G W G G G G G G G G G G G D G G W
W G G G G G G G W G G G G G G G G G G G W G G G G G G G G G G G G G W G G G G R G G G G G G G G G W 
W W W W W W W W W W W W W W W W W W W W W W W W G G W W W W W W W W W W W W W W W W W W W W W W W W 
W G G G G G G G W G G G G G G G G G G G W G G W G G W G G G G G G G W G G G G G G G G G G G G G G W 
W G G G G G G G W G G G G G G G G G G D W G R G G G G G G G G G G G W G G G G G G G G G G G G G G W 
W G G G G G G G W G R G G G G G G G G G W G G G G G G G G G G G G G W G G G G G G G R G G G G G G W 
W G G G G G G G G G G G G G G G G G G G G G G G G G D G D G G G G R G G G G G G G G D G G G G G G W
W G G G G G G G W G G G G G G G G G G G W G G G G G G G G G G G G G W G G G G G D G G G G G G G G W
W G G G G G G G W G G G D G G D G G G G W G G G G G G G G G G G G G W G G G G G G G G G G G G G G W
W G G G G R G G W G G G G G G G G G G G W G G G G G G G G G G G G G W G G G G G G G G G G G G G G W 
W W W W W W W W W W W W W W W W W W W W W W W W W W W W W W W W W W W W W W W W W W W W W W W W G W  
W G G G G G G G W D G G G G G G G G G G W G G G G G G G G G G G G G W G G G G G G G G G G G G W G W 
W G G G G G G G W G R G G G G G G G G G W G G G G G G G G R G G G G W G G G G G G G G G G W W W G W 
W G G G G G G G W G G G G G G G G R G G W G G G G G G G G G G G G G W G G G G G G G G G G G G G G W 
W G G G G G D G W G G G G G G G G G G G W G G G G G G G G G G G G G W G R G G G D G G G G W W W W W 
W G G G G G D G G G G G G R G G G G G G G G G G G G G G G G D G G G G G G G G G G G G G G G G G G W
W G G G G G G G W G G G G G G G G G G G W G G G G G G G G G G G G G W G G G G G R G G G G G G G G W 
W G G G G G G G W G G G G G G G G G D R W G G G G G G G G G R G G G W G G G G G G G G G R G G G G W 
W G G G G G G G W G G G G G G G G G G G W G G G G G G G D G G G G G W G G G G G G G G G G G G G G W 
W G G G G G G G W G G G G G G G G G G G W G G G G G G G G G G G G G W G G G G G G D G G G G G G G W 
W W W W G W W W W W W W W W W W W W W W W W W W W W W W W W W W W W W W W W W W W W W W W W W W W W
W G G G G G G G W G G G G G G G G G G G W G G G G G G G G G G G G G W G G R G G G G G G G G G G G W 
W G G G G G G G W G G G G G G G G R G G W G R G G G G G G G G G G G W G G G G G G G G G R G G G G W 
W G G G G G G G W G R G G G G G G G G G W G G G R G G G R G G D G G W G G G G G G D G G G G G G G W 
W G G G R G G G W G G G G G G G G G G G W G G G G G G G G G G G G G W G G G G G G G G G G G G G G W  
W G G G G G G R G G G G G G G G G G G G G G G G G G D G G G G G G G G G G G G G G G G G G G G G G W 
W G G G G G G G W G G G G G G G D G G G W G G G G R G G G G G G R G W G G G G G R G G G G G G G G W 
W G G R G D G G W G G G G G R G G G G G W G G G G G G G G G G G G G W G G G G G G G G G G G G G G W 
W G G G G G G G W G G D G G G G G G G G W G G G G G G G G G G G G G W G G G G G G G G G G G G G G W 
W G G G G G G G W G G G G G G G G G G G W G G G G G G G G G G G G G W G G G G G G G G G G O O O O W 
W W W W W W W W W W W W W W W W W W W W W W W W W W W W W W W W W W W W W W W W W W W W W W W W W W